1111111111111111111111111111111111111111111111111111111111111111111111111111111111111111111111111111
1110000000000000000000000000000000000000000000000110000000000000000000000000000000000000000000000111
1110011111111111100111111111111001100110011111100110011111111111111111111111111111111111111111100111
1110011111111111100111111111111001100110011000000110000000000000000000000000000000000000000000000111
1110011111111111100111111111111001100110011001100110011111111110011111111111111111111111111111111111
1110011111111111100111111111111001100110000001100110011000000110000000000000000000000000000000000111
1110000000000000000000000000000001100110011001100110011001100110011110011001111111111111111111100111
1110011111111111100111111001111111100110011001100110011001100110011110011000000000000000000000000111
1110011111111111100111111000000000000110011001100110011001100110011110011001111110011111111111100111
1110000000000000000111111001111110000000011000000000000001100000000000011001111110011000000000000111
1111111111111001100111111001111110011110011111111111111111100111111110011001111110011001111111111111
1111111111111001100111111000000110011000000000000000000000000111111110011001111110000001111111111111
11111111111110011001111110011001100110011111111....1111111100111111110011001111110011001111111111111
11111111111110011000000000011001100110011................1100111111110011000000000011001111111111111
1112.000000000011111111110011001100110011................1100111111110011001111111111000000000000000
111111111111100110000000000110011001100113.............4.1100111111110011000000000011001111111111111
1111111111111001100111111001100110011001111111111111111111100111111110011001111110011001111111111111
1111111111111001100111111001100000000000000000000000000000000000000000011001111110000001111111111111
1111111111111001100111111001111111111001100111111111111111111111111110011001111110011001111111111111
1110000000000000000000000000000000000001100111111111111111111111111110011001111110011000000000000111
1110011111111111100111111111100111111001100000000000011000000000000000011001111110011111111111100111
1110000000000001100111111111100111111001100111100110011001111111111110011000000000000000000000000111
1110011111111000000111111111100111111001100111100110011000000000000110011001111111111111111111100111
1110000000011001100111111111100000000001100111100110011001111111100000000000000000000000000000000111
1111111110011001100111111111100110011001100111100110000000000000000111111001100111111111111111100111
1110000000000001100000000000000110011001100111100110011111111111100111111001100111111111111111100111
1110011111111111111110011111111110011000000000000110000000000001100000000001100111111111111111100111
1110011111111111111110011111111110011001111111111111111111111001100111111111100111111111111111100111
1110000000000000000000000000000000000000000000000000000000000000000000000000000000000000000000000111
1111111111111111111111111111111111111111111111111111111111111111111111111111111111111111111111111111
